Titre : "mapEdited"
..............
.....WTB......
..........S...
......W.......
..........W...
........W.....
.........W....
..............
..............
..............
..............