Titre : "mapSaved"
1
16
W][W][W][W][W][W][W][W][W][W][W][W][W][W][
W][T][W][K][.][.][W][.][.][.][.][.][.][W][
W][.][W][W][.][.][D][.][.][.][.][.][.][W][
W][.][W][W][W][D][W][W][.][W][W][W][W][W][
W][.][.][.][.][.][W][.][.][.][.][.][.][W][
W][.][.][.][.][.][W][.][.][.][.][.][.][W][
W][.][B][.][.][.][D][B][T][.][.][.][.][W][
W][.][T][.][.][.][W][.][.][.][.][.][.][W][
W][.][.][.][.][.][W][.][.][.][.][.][.][W][
W][.][.][.][.][B][W][.][.][.][.][.][J][W][
W][W][W][W][W][W][W][W][W][W][W][W][W][W][
